# 텍스처 경로
NO ./textures/north_texture.xpm
SO ./textures/south_texture.xpm
WE ./textures/west_texture.xpm
EA ./textures/east_texture.xpm

# 잘못된 색상 값
F 220,100
C 135,206,250

# 기본 맵 데이터
111111
100001
1010N1
100001
111111
