# 텍스처 경로
NO ./textures/north_texture.xpm
SO ./textures/south_texture.xpm
WE ./textures/west_texture.xpm
EA ./textures/east_texture.xpm

# 색상 값 (R, G, B)
F 150,150,150
C 200,200,200

# 넓은 공간 맵 데이터
111111111111
100000000001
100000000001
10000N000001
100000000001
100000000001
111111111111
