# 텍스처 경로
NO ./textures/north_texture.xpm
SO ./textures/south_texture.xpm
WE ./textures/west_texture.xpm
EA ./textures/east_texture.xpm

# 색상 값 (R, G, B)
F 100,50,50
C 50,100,150

# 미로 맵 데이터
111111111
100000001
101111101
101000101
101011101
1000000N1
111111111
